NO ./sprite/forest.xpm
SO ./sprite/forest.xpm
WE ./sprite/forest.xpm
EA ./sprite/forest.xpm


F 34,125,70
C 135,206,235

11111111111111111111111111111111111111111111111111
10000CCCCCCCCCCCCCCCCCCCCCCc0000000000000000000c01
11111111111111111111111111111111111111111111111111
