111111111111111111111111111111111111111111111111111111111111111111111111111111111111111111
100000000010000000000000000000000000000010001000000000000000000000000000000000000000000001
100000000010000000000000000000000000000010001000000000000000000000000000000000000000000001
100000000010000000000000000000000000000010001000000000000000000000000000000000000000000001
100000000010000000000000000000000000000010001000000000000000000000000000000000000000000001
10000S000010000011111111111111111100000001001000000000000000000000000000000000000000000011
100000000010000100000000000000000101000100010000011111111111111111111111111111111111000011
100000000010001000000000000000000001000001001000001000000000000000000000000000000000100001
100000000010010000000000000000000001000010001000001000000000000000000000000000000011000011
100000000010011111111111000000000001000001001000001000000011111111111100000000001100000101
100000000010000000000001000000000001000010001000001000000100000000000100000000011000001001
100000000011111111110001000000000001000001001000001000000100111111100100000000000000010001
100000000010000000000001000000000001000010001000001000000100100000100100000000000000100001
100000000010010000000001000000000001000001001000001000000100100000100111111111111111001111
100000000010000011111110000000000001000010001000001000000100100000000000000000000000000001
111111111111111111111111111111111111111111111111111111111111111111111111111111111111111111
